Name:,Nancy,,,,,,
Gender (enter M or F):,F,,,,,,
Capacity:,5,,,,,,
Level (1 - in 401; 2 - in 410/411; 3 - in major),2,,,,,,
,0. Sun,1. Mon,2. Tue,3. Weds,4. Thu,5. Fri,6. Sat
0,0,0,0,0,0,0,0,
1,0,0,0,0,0,0,0,
2,0,0,0,0,0,0,0,
3,0,0,0,0,0,0,0,
4,0,0,0,0,0,0,0,
5,0,0,0,0,0,0,0,
6,0,0,0,0,0,0,0,
7,0,0,0,0,0,0,0,
8,0,0,0,0,0,0,0,
9,1,0,0,0,0,1,0,
10,0,0,0,1,1,0,0,
11,0,0,0,0,0,0,0,
12,0,0,1,1,1,0,0,
13,0,0,0,0,0,0,0,
14,0,0,0,0,0,0,0,
15,0,1,0,0,0,0,0,
16,1,0,1,0,0,0,1,
17,0,0,0,0,0,0,1,
18,0,0,0,1,1,0,0,
19,0,0,0,0,0,0,0,
20,1,1,0,0,1,1,1,
21,0,0,1,0,0,1,0,
22,0,0,0,0,0,0,0,
23,0,0,0,0,0,0,0,
