,0. Sun,1. Mon,2. Tue,3. Weds,4. Thu,5. Fri,6. Sat
0,0,0,0,0,0,0,0
1,0,0,0,0,0,0,0
2,0,0,0,0,0,0,0
3,0,0,0,0,0,0,0
4,0,0,0,0,0,0,0
5,0,0,0,0,0,0,0
6,0,0,0,0,0,0,0
7,0,0,0,0,0,0,0
8,0,0,0,0,0,0,0
9,2,2,2,2,2,2,2
10,2,2,2,2,2,2,2
11,2,2,2,2,2,2,2
12,2,2,2,2,2,2,2
13,2,2,2,2,2,2,2
14,2,2,2,2,2,2,2
15,2,2,2,2,2,2,2
16,2,2,2,2,2,2,2
17,4,4,4,4,4,4,4
18,4,4,4,4,4,4,4
19,4,4,4,4,4,4,4
20,4,4,4,4,4,4,4
21,4,4,4,4,4,4,4
22,0,0,0,0,0,0,0
23,0,0,0,0,0,0,0
